   		SO ./textures/Birch.png
NO        ./textures/Jungle.png
WE ./textures/Oak.png
EA ./textures/Spruce.png

F 220,100,0
C 225,30,0

        1111111111111111111111111
        1000000000110000000000001
        1011000001110000000000001
        1001000000000000000000001
111111111011000001110000000000001
100000000011000001110111011111111
11110111111111011100000000001
11110111111111011101010010001
11000000110101011100000010001
10000000000000001100000010001
10000000000000001101010010111
11000001110101011111011110N0111
11110111 1110101 111111010001
11111111 1111111 111111111111