
NO textures/easports.png
WE textures/easports.png
EA textures/easports.png
SO textures/easports.png

F 255,255,255
C 255,255,255



111111111111111111111111111111111111111111111111111111111111111111111111111111111111111111111111111111111111111111111111111111111111111111111111111111111111111111111111111111111111111111111111111111111
1                                                                                   1111111111111111111111111111111111                                                                                   1
1                                                                           11111111111111111111111111111111111111111111111111                                                                           1
1                                                                    1111111111111111111111111111111111111111111111111111111111111111                                                                    1
1                                                               11111111111111111111111111111111111111111111111111111111111111111111111111                                                               1
1                                                           1111111111111111111111111111111111111111111111111111111111111111111111111111111111                                                           1
1                                                        1111111111111111111111111111111111111111111111111111111111111111111111111111111111111111                                                        1
1                                                   11111111111111111111111111111111111111111111111111111111111111111111111111111111111111111111111111                                                   1
1                                                11111111111111111111111111111111111111111111111111111111111111111111111111111111111111111111111111111111                                                1
1                                              111111111111111111111111111111111111111111                        111111111111111111111111111111111111111111                                              1
1                                           11111111111111111111111111111111111                                            11111111111111111111111111111111111                                           1
1                                        11111111111111111111111111111111                                                        11111111111111111111111111111111                                        1
1                                      111111111111111111111111111111                                                                111111111111111111111111111111                                      1
1                                    111111111111111111111111111                                                                          111111111111111111111111111                                    1
1                                  11111111111111111111111111                                                                                 1111111111111111111111111                                  1
1                               11111111111111111111111111                                                                                      11111111111111111111111111                               1
1                              111111111111111111111111                                                                                            111111111111111111111111                              1
1                            11111111111111111111111                                                                                                  11111111111111111111111                            1
1                          1111111111111111111111                                                                                                        1111111111111111111111                          1
1                        1111111111111111111111                                                                                                            1111111111111111111111                        1
1                       111111111111111111111                                                                                                                111111111111111111111                       1
1                     111111111111111111111                                                                                                                    111111111111111111111                     1
1                    11111111111111111111                                                                                                                        11111111111111111111                    1
1                   1111111111111111111                                                                                                                            1111111111111111111                   1
1                 1111111111111111111                                                                                                                                1111111111111111111                 1
1                1111111111111111111                                                                                                                                  1111111111111111111                1
1               1111111111111111111                            1111111111111111111111111111111111111111111111111111          11                                         111111111111111111               1
1              111111111111111111                             11111111111111111111111111111111111111111111111111111        11111                                         111111111111111111              1
1             111111111111111111                             1111111111111111111111111111111111111111111111111111         1111111                                         111111111111111111             1
1            11111111111111111                             11111111111111111111111111111111111111111111111111111         111111111                                          11111111111111111            1
1           11111111111111111                             11111111111111111111111111111111111111111111111111111         11111111111                                          11111111111111111           1
1          11111111111111111                             11111111111111111111111111111111111111111111111111111         1111111111111                                          11111111111111111          1
1         11111111111111111                             11111111111111111111111111111111111111111111111111111         111111111111111                                          11111111111111111         1
1        11111111111111111                             11111111111111111111111111111111111111111111111111111         111111111111111111                                         11111111111111111        1
1       11111111111111111                                                                                          111111111111111111111                                         11111111111111111       1
1       1111111111111111                                                                                          11111111111111111111111                                         1111111111111111       1
1      1111111111111111                                                                                          1111111111111111111111111                                         1111111111111111      1
1     1111111111111111                                                                                          111111111111111111111111111                                         1111111111111111     1
1     1111111111111111                                                                                         11111111111111111111111111111                                         111111111111111     1
1    1111111111111111                                                                                         1111111111111111111111111111111                                        1111111111111111    1
1    111111111111111                           11111111111111111111111111111111111111111111111111           11111111111111111 11111111111111111                                       111111111111111    1
1   1111111111111111                          11111111111111111111111111111111111111111111111111           11111111111111111   11111111111111111                                      1111111111111111   1
1  1111111111111111                          1111111111111111111111111111111111111111111111111            11111111111111111      1111111111111111                                      1111111111111111  1
1  1111111111111111                        11111111111111111111111111111111111111111111111111            1111111111111111   S     1111111111111111                                     1111111111111111  1
1 1111111111111111                        11111111111111111111111111111111111111111111111111            1111111111111111           1111111111111111                                     1111111111111111 1
1 111111111111111                        11111111111111111111111111111111111111111111111111           11111111111111111             1111111111111111                                     111111111111111 1
1 111111111111111                       11111111111111111111111111111111111111111111111111            1111111111111111               1111111111111111                                    111111111111111 1
1 111111111111111                                 11111111111111111                                 11111111111111111         1111111111111111111111111                                  111111111111111 1
11111111111111111                                11111111111111111                                 11111111111111111        1111111111111111111111111111                                 11111111111111111
1111111111111111                                11111111111111111                                 11111111111111111        111111111111111111111111111111                                 1111111111111111
1111111111111111                               1111111111111111                                  1111111111111111         11111111111111111111111111111111                                1111111111111111
1111111111111111                              1111111111111111                                  1111111111111111         1111111111111111111111111111111111                               1111111111111111
1111111111111111                             1111111111111111                                 11111111111111111         111111111111111111111111111111111111                              1111111111111111
1111111111111111                           11111111111111111                                 11111111111111111         11111111111111111111111111111111111111                             1111111111111111
1111111111111111                          1111111111111111111111111111111111111111111111111111111111111111111                                 11111111111111111                           1111111111111111
1111111111111111                         1111111111111111111111111111111111111111111111111111111111111111111                                   11111111111111111                          1111111111111111
1111111111111111                        1111111111111111111111111111111111111111111111111111111111111111111                                      1111111111111111                         1111111111111111
1111111111111111                       111111111111111111111111111111111111111111111111111111111111111111                                         1111111111111111                        1111111111111111
1111111111111111                      111111111111111111111111111111111111111111111111111111111111111111                                           1111111111111111                       1111111111111111
1111111111111111                     111111111111111111111111111111111111111111111111111111111111111111                                             11111111111111111                     1111111111111111
1111111111111111                   1111111111111111111111111111111111111111111111111111111111111111111                                               11111111111111111                    1111111111111111
1111111111111111                                                                                                                                                                          1111111111111111
1111111111111111                                                                                                                                                                          1111111111111111
11111111111111111                                                                                                                                                                        11111111111111111
11111111111111111                     1111111111111       1111111111111111          1111111111111        111111111111111      1111111111111111111      1111111111111                     111111111111111 1
1 111111111111111                   11111111111111111     111111111111111111      11111111111111111      111111111111111111  11111111111111111111    11111111111111111 111111            111111111111111 1
1 111111111111111                  111111111111111111     1111111111111111111    1111111111111111111     1111111111111111111  1111111111111111111   11111111111111111111  1 1            111111111111111 1
1 1111111111111111                1111111       111111    111111       111111    111111       111111     111111      1111111         11111          111111       111111                 1111111111111111 1
1  1111111111111111               111111        111111    111111       111111    111111       111111     111111       111111         11111          11111        111111                1111111111111111  1
1  1111111111111111               1111111                 111111       111111    111111       111111     111111       111111         11111          11111                              1111111111111111  1
1   1111111111111111              11111111111111111       111111       111111    111111       111111     111111      1111111         11111          1111111111111111                  1111111111111111   1
1    111111111111111               111111111111111111     1111111111111111111    111111       111111     111111111111111111          11111           11111111111111111                111111111111111    1
1    1111111111111111                1111111111111111     111111111111111111     111111       111111     11111111111111111           11111            11111111111111111              1111111111111111    1
1    1111111111111111                           111111    11111111111111111      111111       111111     1111111111111111            11111                       111111              1111111111111111    1
1     1111111111111111             11111        111111    111111                 111111       111111     111111    111111            11111          11111        111111             1111111111111111     1
1      1111111111111111           111111        111111    111111                 111111       111111     111111     111111           11111          11111        111111            1111111111111111      1
1       1111111111111111          1111111      1111111    111111                 1111111     1111111     111111      111111          11111          111111      1111111           1111111111111111       1
1       11111111111111111          111111111111111111     111111                  111111111111111111     111111      1111111         11111          1111111111111111111          11111111111111111       1
1        11111111111111111          1111111111111111      111111                   1111111111111111      111111       111111         11111           1111111111111111           11111111111111111        1
1         11111111111111111            1111111111          1111                       111111111           1111         11111         11111              1111111111             11111111111111111         1
1          11111111111111111                                                                                                                                                  11111111111111111          1
1           11111111111111111                                                                                                                                                11111111111111111           1
1            11111111111111111                                                                                                                                              11111111111111111            1
1             111111111111111111                                                                                                                                          111111111111111111             1
1              111111111111111111                                                                                                                                        111111111111111111              1
1               111111111111111111                                                                                                                                      111111111111111111               1
1                1111111111111111111                                                                                                                                  1111111111111111111                1
1                 1111111111111111111                                                                                                                                1111111111111111111                 1
1                   1111111111111111111                                                                                                                            1111111111111111111                   1
1                    11111111111111111111                                                                                                                        11111111111111111111                    1
1                     111111111111111111111                                                                                                                    111111111111111111111                     1
1                       111111111111111111111                                                                                                                111111111111111111111                       1
1                        1111111111111111111111                                                                                                            1111111111111111111111                        1
1                          1111111111111111111111                                                                                                        1111111111111111111111                          1
1                            11111111111111111111111                                                                                                  11111111111111111111111                            1
1                              111111111111111111111111                                                                                            111111111111111111111111                              1
1                               11111111111111111111111111                                                                                      11111111111111111111111111                               1
1                                 111111111111111111111111111                                                                                 11111111111111111111111111                                 1
1                                    111111111111111111111111111                                                                          111111111111111111111111111                                    1
1                                      111111111111111111111111111111                                                                111111111111111111111111111111                                      1
1                                        11111111111111111111111111111111                                                        11111111111111111111111111111111                                        1
1                                           11111111111111111111111111111111111                                            11111111111111111111111111111111111                                           1
1                                              11111111111111111111111111111111111111111                          11111111111111111111111111111111111111111                                              1
1                                                11111111111111111111111111111111111111111111111111111111111111111111111111111111111111111111111111111111                                                1
1                                                   11111111111111111111111111111111111111111111111111111111111111111111111111111111111111111111111111                                                   1
1                                                        1111111111111111111111111111111111111111111111111111111111111111111111111111111111111111                                                        1
1                                                           1111111111111111111111111111111111111111111111111111111111111111111111111111111111                                                           1
1                                                               11111111111111111111111111111111111111111111111111111111111111111111111111                                                               1
1                                                                    1111111111111111111111111111111111111111111111111111111111111111                                                                    1
1                                                                           11111111111111111111111111111111111111111111111111                                                                           1
1                                                                                   1111111111111111111111111111111111                                                                                   1
111111111111111111111111111111111111111111111111111111111111111111111111111111111111111111111111111111111111111111111111111111111111111111111111111111111111111111111111111111111111111111111111111111111