SO textures/Jungle.png
WE textures/Oak.png
EA textures/Spruce.png
NO textures/Birch.png

F 10,150,0
C 0,235,235

                                1111111111111111111111111111111111111111111111111111111111
                                11100000000000000000000000000000000000000000000000000000001
                                11100000000000000000000000000000000000000000000000000000001
                                1110001111111111111111111111111111111111111111111111111111
                                11100011
                                11100011
                                11100011
                                11100011
                                11100011
                                11100011
                                11100011
1111111111111111111111111111111111100011
                                11100011
           11111111111111111111111101011
           1E00000000000 0000000000000011
           11111111101111111111111100011
           11111111101111111111111100111
           11111111101111111111111100011
           11111111101111111111111110011
           11111111101111111111111100011
111111111111111111110111111111111000000111
111101111111110111000000100011100000010001
111101111111110111010100100011100111111001
110000001101010111000000100011000000001001
100000000000000011000000000000001001001111
100000000000000011010100100011000000001
11000001110101011111011110001111111001111
11110111 1110101 101111010001   100000001
11111111 1111111 111111111111111100000001111
                              10000000000001
                              10000001000101
                              11111111111111