NO textures/Jungle.png			
SO textures/Birch.png			
WE textures/Oak.png			
EA textures/Spruce.png	

F 146, 109, -39
C 135, 206, 235

1111111
100S001
1111111







