NO textures/Jungle.png
SO textures/Birch.png
WE textures/Oak.png
EA textures/Spruce.png

F 146,109,39
C 135,206,235

111111110111
1         11
1       0001
1000000 0011
10S000000001
111111111111
11         1
111111111111