NO textures/Jungle.png			
SO textures/Birch.png			
WE textures/Oak.png			
EA textures/Spruce.png	

F 146,109,39


     11111  
    100S001
     10001
      111
       1

C 135, 206, 235